0,0,0,0,0,0,0,0,0,0,0,0
0,0,0,0,0,0,0,0,0,0,0,0
0,0,0,0,0,0,0,0,0,0,0,0
0,0,0,0,0,0,0,0,0,0,0,0
0,0,0,0,0,0,0,0,0,0,0,0
0,0,0,0,0,0,0,0,0,0,0,0
c,0,0,0,0,1,2,3,0,0,0,f
1,2,2,2,2,2,2,2,2,2,2,3
7,8,8,8,8,8,8,8,8,8,8,9